NO ./textures/wall/wallN.xpm
EA ./textures/wall/wallE.xpm
SO ./textures/wall/wallS.xpm
WE ./textures/wall/wallW.xpm

F 255,20,147
C 220,20,60

        1111111111111111111111111
        1000000000110000000000001
        1010000001110000000000001
        1001000000000000000000000111
1111111110110000011100000000000001111
10000000001100000111011111111111111
11110111111111011100000010001
1111011111111101110101001000111111111
11000000110101011100000010001
10000000000000001100000010001
10000000000000001101010010001
11000001110101011111011110N011
11110111 1110101 101111010001
11111111 1111111 111111111111